-15
15
-7
5
0000000000000000000000000000000
0000000000000000000000000000000
0000000000000000000000011111110
0000000000000000000000011111110
0000000000000000000000011111110
0000000000001000000100011111110
0000000000000000000000011111110
0000000000000000000000011111110
0000000000000000000000011111110
0000000000000000000000000000000
0000000000000000000000000000000
0000000000000000000000000000000
0000000000000000000000000000000
